"filename", "language", "CMake", "C++", "Markdown", "comment", "blank", "total"
"/home/ggy/myProject/CMakeLists.txt", "CMake", 8, 0, 0, 0, 2, 10
"/home/ggy/myProject/doc/IOSocket.md", "Markdown", 0, 0, 22, 0, 8, 30
"/home/ggy/myProject/doc/serialization.md", "Markdown", 0, 0, 1, 0, 1, 2
"/home/ggy/myProject/doc/timer.md", "Markdown", 0, 0, 24, 0, 3, 27
"/home/ggy/myProject/src/address.cpp", "C++", 0, 323, 0, 6, 63, 392
"/home/ggy/myProject/src/address.h", "C++", 0, 94, 0, 0, 30, 124
"/home/ggy/myProject/src/bytearray.cpp", "C++", 0, 559, 0, 0, 100, 659
"/home/ggy/myProject/src/bytearray.h", "C++", 0, 89, 0, 0, 19, 108
"/home/ggy/myProject/src/coroutine.cpp", "C++", 0, -1, 0, 1, 0, 0
"/home/ggy/myProject/src/endian.hpp", "C++", 0, 75, 0, 16, 20, 111
"/home/ggy/myProject/src/fd_manager.cpp", "C++", 0, 87, 0, 0, 15, 102
"/home/ggy/myProject/src/fd_manager.h", "C++", 0, 46, 0, 0, 14, 60
"/home/ggy/myProject/src/hook.cpp", "C++", 0, 409, 0, 0, 65, 474
"/home/ggy/myProject/src/hook.h", "C++", 0, 68, 0, 5, 29, 102
"/home/ggy/myProject/src/iomanager.cpp", "C++", 0, 20, 0, 0, 5, 25
"/home/ggy/myProject/src/iomanager.h", "C++", 0, 3, 0, 0, 2, 5
"/home/ggy/myProject/src/noncopyable.h", "C++", 0, 10, 0, 0, 1, 11
"/home/ggy/myProject/src/scheduler.cpp", "C++", 0, -13, 0, 20, 1, 8
"/home/ggy/myProject/src/scheduler.h", "C++", 0, 1, 0, 0, 0, 1
"/home/ggy/myProject/src/thread.h", "C++", 0, 1, 0, 0, 1, 2
"/home/ggy/myProject/src/timer.cpp", "C++", 0, 142, 0, 0, 26, 168
"/home/ggy/myProject/src/timer.h", "C++", 0, 15, 0, 0, 7, 22
"/home/ggy/myProject/src/utils.cpp", "C++", 0, 4, 0, 0, 1, 5
"/home/ggy/myProject/src/utils.h", "C++", 0, 2, 0, 0, 1, 3
"/home/ggy/myProject/test/test_address.cpp", "C++", 0, 39, 0, 0, 5, 44
"/home/ggy/myProject/test/test_hook.cpp", "C++", 0, 49, 0, 1, 12, 62
"/home/ggy/myProject/test/test_iomanager2.cpp", "C++", 0, 7, 0, 7, 1, 15
"Total", "-", 8, 2029, 47, 56, 432, 2572