"filename", "language", "CMake", "C++", "YAML", "Markdown", "comment", "blank", "total"
"/home/ggy/myProject/CMakeLists.txt", "CMake", 56, 0, 0, 0, 0, 20, 76
"/home/ggy/myProject/config/log.yml", "YAML", 0, 0, 18, 0, 0, 0, 18
"/home/ggy/myProject/doc/IOSocket.md", "Markdown", 0, 0, 0, 22, 0, 8, 30
"/home/ggy/myProject/doc/config.md", "Markdown", 0, 0, 0, 107, 0, 17, 124
"/home/ggy/myProject/doc/coroutine.md", "Markdown", 0, 0, 0, 43, 0, 9, 52
"/home/ggy/myProject/doc/iomanager.md", "Markdown", 0, 0, 0, 4, 0, 2, 6
"/home/ggy/myProject/doc/log.md", "Markdown", 0, 0, 0, 65, 0, 7, 72
"/home/ggy/myProject/doc/serialization.md", "Markdown", 0, 0, 0, 1, 0, 1, 2
"/home/ggy/myProject/doc/thread.md", "Markdown", 0, 0, 0, 119, 0, 19, 138
"/home/ggy/myProject/doc/timer.md", "Markdown", 0, 0, 0, 24, 0, 4, 28
"/home/ggy/myProject/src/address.cpp", "C++", 0, 323, 0, 0, 6, 63, 392
"/home/ggy/myProject/src/address.h", "C++", 0, 94, 0, 0, 0, 30, 124
"/home/ggy/myProject/src/agent.h", "C++", 0, 9, 0, 0, 0, 1, 10
"/home/ggy/myProject/src/bytearray.cpp", "C++", 0, 559, 0, 0, 0, 100, 659
"/home/ggy/myProject/src/bytearray.h", "C++", 0, 89, 0, 0, 0, 19, 108
"/home/ggy/myProject/src/config.cpp", "C++", 0, 66, 0, 0, 10, 11, 87
"/home/ggy/myProject/src/config.h", "C++", 0, 401, 0, 0, 33, 41, 475
"/home/ggy/myProject/src/coroutine.cpp", "C++", 0, 225, 0, 0, 12, 33, 270
"/home/ggy/myProject/src/coroutine.h", "C++", 0, 53, 0, 0, 11, 18, 82
"/home/ggy/myProject/src/endian.hpp", "C++", 0, 75, 0, 0, 16, 20, 111
"/home/ggy/myProject/src/fd_manager.cpp", "C++", 0, 87, 0, 0, 0, 15, 102
"/home/ggy/myProject/src/fd_manager.h", "C++", 0, 46, 0, 0, 0, 14, 60
"/home/ggy/myProject/src/hook.cpp", "C++", 0, 409, 0, 0, 0, 65, 474
"/home/ggy/myProject/src/hook.h", "C++", 0, 68, 0, 0, 5, 29, 102
"/home/ggy/myProject/src/iomanager.cpp", "C++", 0, 324, 0, 0, 5, 68, 397
"/home/ggy/myProject/src/iomanager.h", "C++", 0, 61, 0, 0, 0, 17, 78
"/home/ggy/myProject/src/log.cpp", "C++", 0, 800, 0, 0, 68, 88, 956
"/home/ggy/myProject/src/log.h", "C++", 0, 194, 0, 0, 41, 57, 292
"/home/ggy/myProject/src/macro.h", "C++", 0, 22, 0, 0, 0, 4, 26
"/home/ggy/myProject/src/noncopyable.h", "C++", 0, 10, 0, 0, 0, 1, 11
"/home/ggy/myProject/src/scheduler.cpp", "C++", 0, 198, 0, 0, 23, 33, 254
"/home/ggy/myProject/src/scheduler.h", "C++", 0, 123, 0, 0, 1, 21, 145
"/home/ggy/myProject/src/singleton.h", "C++", 0, 27, 0, 0, 0, 2, 29
"/home/ggy/myProject/src/thread.cpp", "C++", 0, 104, 0, 0, 1, 13, 118
"/home/ggy/myProject/src/thread.h", "C++", 0, 267, 0, 0, 2, 44, 313
"/home/ggy/myProject/src/timer.cpp", "C++", 0, 171, 0, 0, 0, 30, 201
"/home/ggy/myProject/src/timer.h", "C++", 0, 51, 0, 0, 0, 20, 71
"/home/ggy/myProject/src/utils.cpp", "C++", 0, 72, 0, 0, 0, 17, 89
"/home/ggy/myProject/src/utils.h", "C++", 0, 18, 0, 0, 0, 7, 25
"/home/ggy/myProject/test/test_address.cpp", "C++", 0, 39, 0, 0, 0, 5, 44
"/home/ggy/myProject/test/test_config.cpp", "C++", 0, 181, 0, 0, 4, 26, 211
"/home/ggy/myProject/test/test_coroutine.cpp", "C++", 0, 33, 0, 0, 0, 7, 40
"/home/ggy/myProject/test/test_hook.cpp", "C++", 0, 49, 0, 0, 1, 12, 62
"/home/ggy/myProject/test/test_iomanager.cpp", "C++", 0, 16, 0, 0, 1, 4, 21
"/home/ggy/myProject/test/test_iomanager2.cpp", "C++", 0, 45, 0, 0, 10, 13, 68
"/home/ggy/myProject/test/test_log.cpp", "C++", 0, 19, 0, 0, 17, 6, 42
"/home/ggy/myProject/test/test_scheduler.cpp", "C++", 0, 19, 0, 0, 3, 4, 26
"/home/ggy/myProject/test/test_thread.cpp", "C++", 0, 40, 0, 0, 20, 14, 74
"/home/ggy/myProject/test/test_util.cpp", "C++", 0, 13, 0, 0, 0, 4, 17
"Total", "-", 56, 5400, 18, 385, 290, 1063, 7212