"filename", "language", "CMake", "C++", "YAML", "Markdown", "comment", "blank", "total"
"/home/ggy/myProject/CMakeLists.txt", "CMake", 48, 0, 0, 0, 0, 18, 66
"/home/ggy/myProject/config/log.yml", "YAML", 0, 0, 18, 0, 0, 0, 18
"/home/ggy/myProject/doc/config.md", "Markdown", 0, 0, 0, 107, 0, 17, 124
"/home/ggy/myProject/doc/coroutine.md", "Markdown", 0, 0, 0, 43, 0, 9, 52
"/home/ggy/myProject/doc/iomanager.md", "Markdown", 0, 0, 0, 4, 0, 2, 6
"/home/ggy/myProject/doc/log.md", "Markdown", 0, 0, 0, 65, 0, 7, 72
"/home/ggy/myProject/doc/thread.md", "Markdown", 0, 0, 0, 119, 0, 19, 138
"/home/ggy/myProject/doc/timer.md", "Markdown", 0, 0, 0, 0, 0, 1, 1
"/home/ggy/myProject/test/test_config.cpp", "C++", 0, 181, 0, 0, 4, 26, 211
"/home/ggy/myProject/test/test_coroutine.cpp", "C++", 0, 33, 0, 0, 0, 7, 40
"/home/ggy/myProject/test/test_iomanager.cpp", "C++", 0, 16, 0, 0, 1, 4, 21
"/home/ggy/myProject/test/test_iomanager2.cpp", "C++", 0, 38, 0, 0, 3, 12, 53
"/home/ggy/myProject/test/test_log.cpp", "C++", 0, 19, 0, 0, 17, 6, 42
"/home/ggy/myProject/test/test_scheduler.cpp", "C++", 0, 19, 0, 0, 3, 4, 26
"/home/ggy/myProject/test/test_thread.cpp", "C++", 0, 40, 0, 0, 20, 14, 74
"/home/ggy/myProject/test/test_util.cpp", "C++", 0, 13, 0, 0, 0, 4, 17
"Total", "-", 48, 359, 18, 338, 48, 150, 961