"filename", "language", "CMake", "C++", "YAML", "Markdown", "comment", "blank", "total"
"/home/ggy/myProject/CMakeLists.txt", "CMake", 48, 0, 0, 0, 0, 18, 66
"/home/ggy/myProject/config/log.yml", "YAML", 0, 0, 18, 0, 0, 0, 18
"/home/ggy/myProject/doc/config.md", "Markdown", 0, 0, 0, 107, 0, 17, 124
"/home/ggy/myProject/doc/coroutine.md", "Markdown", 0, 0, 0, 43, 0, 9, 52
"/home/ggy/myProject/doc/iomanager.md", "Markdown", 0, 0, 0, 4, 0, 2, 6
"/home/ggy/myProject/doc/log.md", "Markdown", 0, 0, 0, 65, 0, 7, 72
"/home/ggy/myProject/doc/thread.md", "Markdown", 0, 0, 0, 119, 0, 19, 138
"/home/ggy/myProject/doc/timer.md", "Markdown", 0, 0, 0, 0, 0, 1, 1
"/home/ggy/myProject/src/agent.h", "C++", 0, 9, 0, 0, 0, 1, 10
"/home/ggy/myProject/src/config.cpp", "C++", 0, 66, 0, 0, 10, 11, 87
"/home/ggy/myProject/src/config.h", "C++", 0, 401, 0, 0, 33, 41, 475
"/home/ggy/myProject/src/coroutine.cpp", "C++", 0, 226, 0, 0, 11, 33, 270
"/home/ggy/myProject/src/coroutine.h", "C++", 0, 53, 0, 0, 11, 18, 82
"/home/ggy/myProject/src/iomanager.cpp", "C++", 0, 304, 0, 0, 5, 63, 372
"/home/ggy/myProject/src/iomanager.h", "C++", 0, 58, 0, 0, 0, 15, 73
"/home/ggy/myProject/src/log.cpp", "C++", 0, 800, 0, 0, 68, 88, 956
"/home/ggy/myProject/src/log.h", "C++", 0, 194, 0, 0, 41, 57, 292
"/home/ggy/myProject/src/macro.h", "C++", 0, 22, 0, 0, 0, 4, 26
"/home/ggy/myProject/src/scheduler.cpp", "C++", 0, 211, 0, 0, 3, 32, 246
"/home/ggy/myProject/src/scheduler.h", "C++", 0, 122, 0, 0, 1, 21, 144
"/home/ggy/myProject/src/singleton.h", "C++", 0, 27, 0, 0, 0, 2, 29
"/home/ggy/myProject/src/thread.cpp", "C++", 0, 104, 0, 0, 1, 13, 118
"/home/ggy/myProject/src/thread.h", "C++", 0, 266, 0, 0, 2, 43, 311
"/home/ggy/myProject/src/timer.cpp", "C++", 0, 29, 0, 0, 0, 4, 33
"/home/ggy/myProject/src/timer.h", "C++", 0, 36, 0, 0, 0, 13, 49
"/home/ggy/myProject/src/utils.cpp", "C++", 0, 68, 0, 0, 0, 16, 84
"/home/ggy/myProject/src/utils.h", "C++", 0, 16, 0, 0, 0, 6, 22
"/home/ggy/myProject/test/test_config.cpp", "C++", 0, 181, 0, 0, 4, 26, 211
"/home/ggy/myProject/test/test_coroutine.cpp", "C++", 0, 33, 0, 0, 0, 7, 40
"/home/ggy/myProject/test/test_iomanager.cpp", "C++", 0, 16, 0, 0, 1, 4, 21
"/home/ggy/myProject/test/test_iomanager2.cpp", "C++", 0, 38, 0, 0, 3, 12, 53
"/home/ggy/myProject/test/test_log.cpp", "C++", 0, 19, 0, 0, 17, 6, 42
"/home/ggy/myProject/test/test_scheduler.cpp", "C++", 0, 19, 0, 0, 3, 4, 26
"/home/ggy/myProject/test/test_thread.cpp", "C++", 0, 40, 0, 0, 20, 14, 74
"/home/ggy/myProject/test/test_util.cpp", "C++", 0, 13, 0, 0, 0, 4, 17
"Total", "-", 48, 3371, 18, 338, 234, 631, 4640